..........
..........
.#######..
.#.....###
##$###...#
#.@.$..$.#
#.OO#.$.##
##OO#...#.
.########.
..........
