..........
..#####...
..#@.###..
..#.$..#..
.###.#.##.
.#O#.#.##.
.#O$.#..#.
.#O...$.#.
.########.
..........
