..........
...####...
..##..#...
..#@$.#...
..##$.##..
..##.$.#..
..#O$..#..
..#OO#O#..
..######..
..........
