..#######.
..#.....#.
..#.$.@.#.
#####.#.#.
#.$.....#.
#..#$##.##
#OO$..#..#
#OO......#
##########
