###################
#...#....#.###OOOO#
#...$$#......OOOOO#
#...#.###...#.OOOO#
##.##.###..#..OOOO#
##.$.$.....#.#.####
##..$.$##..#......#
####.#..####.#.##.#
#..#.#$...##.#....#
#.$..$..#.##.#...##
#.#.$$@....#.#...##
#..@.##.##.#.######
#.@@..@......#.....
##.##.###.@@.#.....
##....###....#.....
##############.....
